######WW##WW#WW#WW##
#     Gf  Gf Gf GfF#
# ####Wp##pW#pW#pW##
#    #W###W##W##W###
#    #w###w##w##w###
#                  #
#         S        #
#                  #
######w---w#########
######w---w#########
####################