####################
#                 F#
####################
#   ####  ##  #### #
#  #     #  #   #  #
#   ###  #  #  #   #
#      # #  # #    #
#  ####   ##  #### #
#                  #
#                  #
####################