###########WW#######
#          wG    F #
#       s##WP#######
#       |###W#######
#       WWWWW#######
####################
####################
####################
####################
####################
####################
####################