###########WW#######
#         wfG    F #
#        ##Wp#######
#        ###W#######
#      s WWWW#######
####################
####################
####################
####################
####################
####################
####################