####################
#        WWW   F   #
#        w w   F   #
#        w w   F   #
#        w w   F   #
#        | w   F   #
#        w w   F   #
#        w w   F   #
#        w w   F   #
#        WPW   F   #
####################