####################
#    s             #
#####W###  ###W#####
#####W###||###W#####
#####W###  ###W#####
#w---p        p---w#
#                  #
#        GG        #
#       WFFW       #
####################
####################
####################
