####################
#                  #
##### ##############
# F # ##############
#   # ffffffsffffff#
#   #|             #
#   # ff ff ff fff #
#   ##WP#WP#WP#WP# #
#     fw fw fw fw  #
######WW#WW#WW#WW###