####################
#         ------   #
#         www|||   #
#       W W        #
#      WlGrW       #
#       WfW  P     #
#      WlGrW       #
########WfW#########
#                  #
#        F         #
####################
