################### 
#    s         s  # 
#####W####  ###W### 
     f   #||#  f    
#####W####  ###W### 
#----p         p--# 
#                 # 
#        GG       # 
#       WFFW      # 
################### 