####################
#                  #
#                  #
#    WWWWW         #
#    W   W         #
#   sp F G         #
#    W   W         #
#    WWWWW         #
#                  #
#                  #
####################