####################
#      #           #
###### #  #  # ### #
##   # #  #  #  #  #
## # # #  ####  #  #
## #   #  #  #  #  #
## ###### #  # ### #
##      #   fPf    #
####### #   f f    #
#F      #   fff    #
####################