###########WW#######
#          wG    F #
#        ##WP#######
#        ###W#######
#      s WWWW#######
####################
####################
####################
####################
####################
####################
####################