###########WP#WP####
#           G  G F #
####WGWWW##WW#WW####
####W   |###########
####W   w###########
####WPwwW###########
####################
####################
####################
####################
####################
