####################
#                 u#
##### ##############
# F # ##############
#   # ffffffsffffff#
#   #d             #
#   # ff ff ff fff #
#   ##WP#Wp#WP#W#p #
#     fw fG fw fGw #
######WW#WW#WW#WWW##