####################
#      #           #
###### #  #  # ### #
##   # #  #  #  #  #
## # # #  ####  #  #
## #   #  #  #  #  #
## ###### #  # ### #
##      #    w-w   #
####### # S--p |   #
#F      #    w-w   #
####################