####################
# s  s s   s   s  s#
# pWWp#pW##pW#Wp##pW
# rrdlllu##du#ud##du
# #ud##ru##du#ud##du
# #ud##u###du#ur#dlu
# #udrrudlllu#dldl#u
# #ddu##d##ru###d##u
# #udu##d##u##dlW##u
# #udu##d##u##d#d#ru
# #udu##d##u#dl#d#u#
# #udu##W##u#d##d#u#
# #udu##d##u#d##dru#
# #lWW#WW#WW#WWWdu##
#   Gf G  G  GffGfF#
####WW#WWWW##WW#WW##
