####################
#                  #
#                  #
#   WruffffW       #
#    ru     ## ### #
#   P      GF# #   #
#    ld     ## ##  #
#   WldffffW   #   #
#                  #
#                  #
####################