####################
#                  #
#                  #
#     ---  #####   #
#   ff   ffW   #   #
#   P      G F #   #
#   fffffffW   #   #
#          #####   #
#                  #
#                  #
####################